01,01,01,01,01,01,01,01
01,01,01,99,01,01,01,01
01,01,13,13,13,12,01,01
01,01,01,10,02,13,01,01
01,00,98,00,00,13,01,01
01,00,00,02,02,13,01,01
01,01,01,01,01,00,99,01
01,01,01,01,01,01,01,01
01,01,01,01,01,01,01,01