01,01,01,01,01,01,01,01,01
01,01,01,02,01,99,00,01,01
01,01,01,98,01,01,01,01,01
01,01,01,11,01,01,01,01,01
01,01,99,02,01,11,00,01,01
01,01,01,01,01,02,01,01,01
01,01,01,01,01,01,01,01,01