00,00,00,00,00,00,00,00,00,01,01,13,01
00,00,00,00,00,00,00,01,00,11,01,13,01
00,00,00,00,00,00,00,01,00,01,01,13,01
00,00,10,02,02,02,10,01,00,13,13,12,13
00,00,00,00,00,00,00,01,00,01,01,13,01
00,98,00,00,00,00,00,00,00,01,01,13,01
00,00,00,00,00,00,00,00,00,01,01,13,01