01,01,01,01,01,01,01,01,01,01
01,01,01,01,01,00,00,00,00,01
01,00,00,00,01,00,01,01,00,01
01,00,98,00,02,12,13,13,99,01
01,00,00,00,00,00,01,01,01,01
01,01,01,01,01,01,01,01,01,01