01,01,01,01,01,01,01,01,01
01,01,01,99,00,00,00,01,01
01,01,01,01,01,01,10,01,01
01,98,01,11,01,10,00,99,01
01,01,01,01,00,01,00,01,01
01,01,01,01,00,01,00,01,01
01,01,01,01,01,01,99,01,01
01,01,01,01,01,01,01,01,01