01,01,01,01,01,01,01,01,01,01
01,01,01,01,01,01,00,00,00,01
01,00,00,00,01,01,00,01,00,01
01,00,98,00,00,00,12,01,99,01
01,00,00,00,00,00,00,01,01,01
01,01,01,01,01,01,01,01,01,01