01,01,01,01,01,01,01,01,01
01,01,01,01,01,99,01,01,01
01,01,01,01,02,01,01,01,01
01,99,01,01,11,01,01,99,01
01,01,01,01,99,01,02,01,01
01,98,01,11,02,11,02,01,01
01,01,01,02,01,01,01,01,01
01,01,01,01,01,01,01,01,01