00,00,00,00,00,99,00,00,00
00,00,00,00,02,00,00,00,00
00,00,00,02,02,00,00,01,00
00,00,00,00,00,00,00,01,00
00,00,00,00,00,00,00,01,00
00,98,00,00,00,00,00,00,00
00,00,00,00,00,00,00,00,00