01,01,01,01,01,01,01,01
01,01,13,01,01,01,01,01
01,99,13,00,99,00,00,01
01,01,13,02,00,00,00,01
01,02,12,13,13,02,00,01
01,01,02,02,13,12,13,02
01,02,12,00,00,02,00,01
01,01,13,02,13,13,12,02
01,01,13,01,00,02,00,01
01,99,13,01,00,01,99,01
01,01,01,01,98,01,01,01
01,01,01,01,01,01,01,01