01,01,01,01,01,01,01,01
01,01,01,01,99,01,01,01
01,00,00,00,00,00,01,01
01,01,01,10,02,00,01,01
01,00,98,11,00,00,01,01
01,00,00,01,02,00,01,01
01,01,01,01,01,00,99,01
01,01,01,02,01,01,01,01
01,01,01,01,01,01,01,01